11111111111111111111111111111111111111111111111111111111111111111111111111111111111111111
11111111111111111111111111111111111111111111111111111111111111111111111111111111111111111
11111111111111111111111111111111111111111111111111111111111111111111111111111111111111111
11111111111111111111111111111111111111111111111111111111111111111111111111111111111111111
11111111111111111111111111111111111111111111111111111111111111111111111111111111111111111
11111111111111111111111111111113311111111111111111111111111111111111111111111111111111111
11111111111111111111111111111222311111111111111111111111111111111111111111111111111111111
11111111111111111111111111112222331111111111111111111111111111111111111111111111111111111
11111111111111111111111111122223211111111111111111111111111111111111111111111111111111111
11111111111111111111111111222222111111111111111111111111111111111111111111111111111111111
11111111111111111111111112222213111111111111111111111111111111111111111111111111111111111
11111111111111111111112222221223311111111111111111111111111111111111111111111111111111111
11111111111111111222222222222222311111111111111111111111111111111111111111111111111111111
11111111111111111222222222222222311111111111111111111111111111111111111111111111111111111
11111111111111111222222222222222311111111111111111111111111111111111111111111111111111111
11111111111111111122222222222223322211111111111111111111111111111111111111111111111111111
11111111111111111122222222222223322222221111111111111111111111111111111111111111111111111
11111111111111111122222222222222322222222222111111111111111111111111111111111111111111111
11111111111111111122222222222222332222232222223111111111111111111111111111111111111111111
11111111111111111122222222222222332232232222223221111111111111111111111111111111111111111
11111111111111111122222222222222332222322222231122222111111111111111111111111111111111111
11111111111111111122222222222222222222332222323111112222211111111111111111111111111111111
11111111111111111122222222222222222223322222223111111111222221111111111111111111111111111
11111111111111111222222222222222222223322222233111111111111122222211111111111111111111111
11111111111111111222222222222222222223222222221111111111111111111222221111111111111111111
11111111111111111322222222222222222223322232231111111111111111111111122222111111111111111
11111111111111111333332222222222222223223322233111111111111111111111111112222211111111111
11111111111111112322322222222222222222233322233111111111111111111111111111111222222111111
11111111111111113332332222202222222222333222231111111111111111111111111111111111112311111
11111111111111112332333322222222222223333322331111111111111111111111111111111111111111111
11111111111111113233232333222222222333233232231111111111111111111111111111111111111111111
11111111111111112223332222222222223332223222231111111111111111111111111111111111111111111
11111111111111113322112333222222233322223222231111111111111111111111111111111111111111111
11111111111111112322112232322222333322223222222111111111111111111111111111111111111111111
11111111111111112222132223322233332222233222222211111111111111111111111111111111111111111
11111111111111112221132223323333322222332222222221111111111111111111111111111111111111111
11111111111111122221113331333332223222232222222222111111111111111111111111111111111111111
11111111111111122221113331113112222222232222222222211111111111111111111111111111111111111
11111111111111123121113331111113222222232222222222222111111111111111111111111111111111111
11111111111111122121111111111111222222222222222222222211111111111111111111111111111111111
11111111111111222121111111111111122222222222222222222221111111111111111111111111111111111
11111111111111222221111111111111132222222222222222222222111111111111111111111111111111111
11111111111111222211111111111111132222222222222222222222211111111111111111111111111111111
11111111111111231211111111111111132222222222222222222222221111111111111111111111111111111
11111111111112211211111111111111113222222222222222222222222111111111111111111111111111111
11111111111112211211111111111111111222222222222222222222222211111111111111111111111111111
11111111111112211211111111111111111122222222222222222222222221111111111111111111111111111
11111111111122111211111111111111111322222222222222222222222222211111111111111111111111111
11111111111122111211111111111111111132222222222222222222222222221111111111111111111111111
11111111111122112211111111111111111112222222222222222222222222222111111111111111111111111
11111111111122112111111111111111111111222222222222222232222222222211111111111111111111111
11111111111221112111111111111111111111222222222222222222222222222221111111111111111111111
11111111111221112111111111111111111111322222222222222222222222222222111111111111111111111
11111111111221112111111111111111111111132222222222222222222222322222211111111111111111111
11111111111321112111111111111111111111132222222222222222222222222222221111111111111111111
11111111112211112111111111111111111111112222222222222222222222223332232111111111111111111
11111111112111122111111111111111111111113222222222222222222333232221322211111111111111111
11111111112111121111111111111111111111111322322222222223223123222322112222111111111111111
11111111112111121111111111111111111111111122222222222223132212232322211223111111111111111
11111111122111121111111111111111111111111132222222222222312311222222221123111111111111111
11111111121111121111111111111111111111111132222222222222231111222223131111111111111111111
11111111121111121111111111111111111111111113222222222222231111122223111111111111111111111
11111111121111121111111111111111111111111113222222222222222111112322211111111111111111111
11111111221111121111111111111111111111111111322222222222222311111123221111111111111111111
11111111211111221111111111111111111111111111122232222323322211111113123111111111111111111
11111111211111211111111111111111111111111111132232333323323323111111111111111111111111111
11111111211111211111111111111111111111111111133333322332223222311111111111111111111111111
11111112211111211111111111111111111111111111111331322323233222211111111111111111111111111
11111112111111211111111111111111111111111111111111132223223323311111111111111111111111111
11111112111111211111111111111111111111111111111111113223333123311111111111111111111111111
11111122111111211111111111111111111111111111111111111222333133311111111111111111111111111
11111121111112211111111111111111111111111111111111111122231111111111111111111111111111111
11111121111112111111111111111111111111111111111111111133231111111111111111111111111111111
11111121111113111111111111111111111111111111111111111133233111111111111111111111111111111
11111221111111111111111111111111111111111111111111111111333111111111111111111111111111111
11111211111111111111111111111111111111111111111111111111111111111111111111111111111111111
11111311111111111111111111111111111111111111111111111111111111111111111111111111111111111
11111111111111111111111111111111111111111111111111111111111111111111111111111111111111111
11111111111111111111111111111111111111111111111111111111111111111111111111111111111111111
11111111111111111111111111111111111111111111111111111111111111111111111111111111111111111
11111111111111111111111111111111111111111111111111111111111111111111111111111111111111111
11111111111111111111111111111111111111111111111111111111111111111111111111111111111111111
